(supertux-level
  (version 3)
  (name (_ "No More Mr. Ice Guy"))
  (author "Carsten Wirtz")
  (license "CC-BY-SA 4.0 International")
  (icon "")
  (icon-locked "")
  (sector
    (name "main")
    (ambient-light
      (color 1 1 1)
    )
    (background
      (color 1 1 1)
      (speed 0)
      (image-top "/images/background/misc/transparent_up.png")
      (image "/images/background/antarctic/snow_panorama.png")
      (z-pos -250)
    )
    (background
      (scroll-offset-y 44)
      (color 1 1 1)
      (scroll-speed-x -5)
      (speed 0.1)
      (speed-y 0)
      (image-top "/images/background/misc/transparent_up.png")
      (image "/images/background/antarctic/ice_floes_front.png")
      (image-bottom "/images/background/antarctic/snow_bottom.png")
      (z-pos -200)
    )
    (background
      (color 1 1 1)
      (scroll-speed-x -0.1)
      (speed 0)
      (image "/images/background/misc/skybox.png")
      (z-pos -290)
    )
    (background
      (scroll-offset-y 10)
      (color 1 1 1)
      (scroll-speed-x -2)
      (speed 0.05)
      (speed-y 0)
      (image "/images/background/antarctic/ice_floes.png")
      (z-pos -220)
    )
    (background
      (color 1 1 1)
      (scroll-speed-x -2)
      (speed 0)
      (image "/images/background/misc/clouds.png")
      (z-pos -280)
    )
    (camera
      (name "Camera")
      (mode "normal")
    )
    (gradient
      (top_color 0.5 0.7 1)
      (bottom_color 1 1 1)
    )
    (music
      (file "/music/antarctic/bossattack.music")
    )
    (particles-snow
    )
    (spawnpoint
      (name "main")
      (x 624)
      (y 672)
    )
    (tilemap
      (solid #t)
      (z-pos 0)
      (width 40)
      (height 30)
      (tiles
      0 0 0 0 0 0 0 0 0 0 0 0 0 0 0 0 0 0 0 0 0 0 0 0 0 0 0 0 0 0 0 0 0 0 0 0 0 0 0 0
      0 0 0 0 0 0 0 0 0 0 0 0 0 0 0 0 0 0 0 0 0 0 0 0 0 0 0 0 0 0 0 0 0 0 0 0 0 0 0 0
      0 0 0 0 0 0 0 0 0 0 0 0 0 0 0 0 0 0 0 0 0 0 0 0 0 0 0 0 0 0 0 0 0 0 0 0 0 0 0 0
      0 0 0 0 0 0 0 0 0 0 0 0 0 0 2909 2910 8 8 8 8 8 8 8 8 8 2913 2914 0 0 0 0 0 0 0 0 0 0 0 0 0
      0 0 0 0 0 0 0 0 2909 2910 8 8 2921 2922 2911 2912 14 14 14 14 3989 3990 14 14 14 2915 2916 2917 2918 8 8 2913 2914 0 0 0 0 0 0 0
      0 0 0 0 0 0 1826 1829 2911 2912 14 14 2923 2924 1834 11 2134 11 2135 11 11 11 11 11 11 11 1835 2919 2920 14 14 2915 2916 1832 1827 0 0 0 0 0
      0 0 0 0 0 4752 1830 1833 1834 11 11 2134 11 11 2134 11 11 11 11 11 11 2135 11 11 2134 11 2135 2135 2134 11 11 11 1835 1836 1831 4753 0 0 0 0
      0 0 0 0 0 4754 1834 11 11 2135 11 2134 11 2134 11 11 11 11 11 11 11 2135 11 2135 11 11 2135 11 11 11 11 2134 2134 11 1835 4755 0 0 0 0
      0 0 0 0 0 3427 2926 2135 2134 2134 2135 2134 2134 2135 2134 2134 11 2135 2134 2134 2134 2134 2135 2135 2135 2135 2135 2134 2135 2135 2134 2135 2134 2134 2929 3428 0 0 0 0
      0 0 0 0 0 0 2928 3991 3991 2925 2926 2135 2135 2134 2134 2134 2929 2930 17 17 17 17 3991 2925 2926 11 2134 11 2135 2929 2930 17 17 17 2931 0 0 0 0 0
      0 0 0 0 0 0 0 0 0 0 2928 17 17 17 17 17 2931 0 0 0 0 0 0 0 2928 17 17 17 17 2931 0 0 0 0 0 0 0 0 0 0
      0 0 0 0 0 0 0 0 0 0 0 0 0 0 0 0 0 0 0 0 0 0 0 0 0 0 0 0 0 0 0 0 0 0 0 0 0 0 0 0
      0 0 0 0 0 0 0 0 0 0 0 0 0 0 0 0 0 0 0 0 0 0 0 0 0 0 0 0 0 0 0 0 0 0 0 0 0 0 0 0
      0 0 0 0 0 0 0 0 0 0 0 0 0 0 0 0 0 0 0 0 0 0 0 0 0 0 0 0 0 0 0 0 0 0 0 0 0 0 0 0
      8 8 8 8 8 8 8 9 0 0 0 0 0 0 0 0 0 0 0 0 0 0 0 0 0 0 0 0 0 0 0 0 7 8 8 8 8 8 8 8
      14 14 3990 14 14 14 3990 15 0 0 0 0 0 0 0 0 0 0 0 0 0 0 0 0 0 0 0 0 0 0 0 0 13 14 14 14 14 14 14 14
      2135 11 11 2135 2135 11 2929 3428 0 0 0 0 0 0 0 0 0 0 0 0 0 0 0 0 0 0 0 0 0 0 0 0 3427 2926 11 2134 11 2135 11 11
      2135 2134 11 11 11 2935 2931 0 0 0 0 0 0 0 0 0 0 0 0 0 0 0 0 0 0 0 0 0 0 0 0 0 0 2928 2933 11 11 11 11 11
      11 2135 2135 11 2940 2936 0 0 0 0 0 0 0 0 0 0 0 0 0 0 0 0 0 0 0 0 0 0 0 0 0 0 0 0 2934 2937 11 2134 11 2134
      11 11 11 11 2941 0 0 0 0 0 0 0 0 0 0 0 0 0 0 0 0 0 0 0 0 0 0 0 0 0 0 0 0 0 0 2938 11 11 11 11
      11 11 2134 30 2942 0 0 0 0 0 0 0 0 0 0 0 0 0 0 0 0 0 0 0 0 0 0 0 0 0 0 0 0 0 0 2939 31 11 2135 11
      11 11 11 12 0 0 0 0 0 0 0 0 0 0 0 0 0 0 0 0 0 0 0 0 0 0 0 0 0 0 0 0 0 0 0 0 10 2135 2134 11
      11 2135 11 12 0 0 0 0 7 8 8 8 8 8 8 8 8 8 8 8 8 8 8 8 8 8 8 8 8 8 8 9 0 0 0 0 10 11 2134 11
      11 11 2135 12 0 0 0 0 13 14 14 14 14 14 14 3988 3990 14 3989 14 14 14 14 14 3988 14 14 14 14 14 14 15 0 0 0 0 10 11 11 2135
      11 11 11 12 0 0 0 0 10 11 2135 2134 11 11 11 11 2134 2134 11 11 11 2134 2135 2134 11 2134 2134 2134 11 2135 11 12 0 0 0 0 10 2134 2135 11
      2134 2134 2135 12 0 0 0 0 10 11 11 11 11 11 2135 11 2135 11 11 2134 2134 11 11 11 11 2135 11 2134 2135 2135 2134 12 0 0 0 0 10 11 2135 2134
      2134 2135 11 12 0 0 0 0 10 2134 2134 11 11 2134 2134 11 11 2134 11 2135 11 11 11 11 11 11 11 11 2134 11 11 12 0 0 0 0 10 2135 11 11
      2135 11 2135 12 0 0 0 0 10 2135 11 11 11 11 11 11 11 11 11 11 11 2134 2135 2135 2134 11 11 26 11 11 11 12 0 0 0 0 10 11 2134 11
      2135 11 11 12 0 0 0 0 10 11 2135 2135 11 2134 11 11 11 11 11 2135 11 11 2134 11 11 11 2134 11 2134 2135 11 12 0 0 0 0 10 11 2134 2135
      2135 2135 2135 12 0 0 0 0 10 2134 11 2135 2135 11 11 2134 2134 11 2134 2134 11 11 11 11 2135 11 11 11 11 2135 11 12 0 0 0 0 10 11 2134 2134
      )
    )
    (tilemap
      (solid #f)
      (z-pos -100)
      (width 40)
      (height 30)
      (tiles
      0 0 0 0 0 0 0 0 0 0 0 0 0 0 0 0 0 0 0 0 0 0 0 0 0 0 0 0 0 0 0 0 0 0 0 0 0 0 0 0
      0 0 0 0 0 0 0 0 0 0 0 0 0 0 0 0 0 0 0 0 0 0 0 0 0 0 0 0 0 0 0 0 0 0 0 0 0 0 0 0
      0 0 0 0 0 0 0 0 0 0 0 0 0 0 0 0 0 0 0 0 0 106 107 108 0 0 0 0 0 0 0 0 0 0 0 0 0 0 0 0
      0 0 0 0 0 0 0 0 0 0 0 0 0 0 0 0 0 2622 0 0 0 109 110 111 0 0 0 0 0 0 0 0 0 0 0 0 0 0 0 0
      0 0 0 0 0 0 0 0 0 0 0 2621 0 0 0 0 0 0 0 0 0 0 0 0 0 0 0 0 0 0 2621 0 0 0 0 0 0 0 0 0
      0 0 0 0 0 0 0 0 0 0 0 0 0 0 0 0 0 0 0 0 0 0 0 0 0 0 0 0 0 0 0 0 0 0 0 0 0 0 0 0
      0 0 0 0 0 0 0 0 0 0 0 0 0 0 0 0 0 0 0 0 0 0 0 0 0 0 0 0 0 0 0 0 0 0 0 0 0 0 0 0
      0 0 0 0 0 0 0 0 0 0 0 0 0 0 0 0 0 0 0 0 0 0 0 0 0 0 0 0 0 0 0 0 0 0 0 0 0 0 0 0
      0 0 0 0 0 0 0 0 0 0 0 0 0 0 0 0 0 0 0 0 0 0 0 0 0 0 0 0 0 0 0 0 0 0 0 0 0 0 0 0
      0 0 0 0 0 0 0 0 0 0 0 0 0 0 0 0 0 0 0 0 0 0 0 0 0 0 0 0 0 0 0 0 0 0 0 0 0 0 0 0
      0 0 0 0 0 0 0 0 0 0 0 0 0 0 0 0 0 0 0 0 0 0 0 0 0 0 0 0 0 0 0 0 0 0 0 0 0 0 0 0
      123 0 0 0 0 0 0 0 0 0 0 0 0 0 0 0 0 0 0 0 0 0 0 0 0 0 0 0 0 0 0 0 0 0 0 0 0 0 0 122
      125 0 0 122 123 0 0 0 0 0 0 0 0 0 0 0 0 0 0 0 0 0 0 0 0 0 0 0 0 0 0 0 0 0 0 122 123 0 0 124
      125 0 0 124 125 0 0 0 0 0 0 0 0 0 0 0 0 0 0 0 0 0 0 0 0 0 0 0 0 0 0 0 0 0 0 124 125 0 0 124
      1344 0 0 1345 1344 0 112 0 0 0 0 0 0 0 0 0 0 0 0 0 0 0 0 0 0 0 0 0 0 0 0 0 0 0 112 1345 1344 0 0 1345
      0 0 0 0 0 0 0 0 0 0 0 0 0 0 0 0 0 0 0 0 0 0 0 0 0 0 0 0 0 0 0 0 0 0 0 0 0 0 0 0
      0 0 0 0 0 0 0 0 0 0 0 0 0 0 0 0 0 0 0 0 0 0 0 0 0 0 0 0 0 0 0 0 0 0 0 0 0 0 0 0
      0 0 0 0 0 0 0 0 0 0 0 0 0 0 0 0 0 0 0 0 0 0 0 0 0 0 0 0 0 0 0 0 0 0 0 0 0 0 0 0
      0 0 0 0 0 0 0 0 0 0 0 0 0 0 0 0 0 0 0 0 0 0 0 0 0 0 0 0 0 0 0 0 0 0 0 0 0 0 0 0
      0 0 0 0 0 0 0 0 0 0 0 0 0 0 0 0 0 0 0 0 0 0 0 0 0 0 0 0 0 0 0 0 0 0 0 0 0 0 0 0
      0 0 0 0 0 0 0 0 0 0 0 0 0 0 0 0 0 0 0 0 0 0 0 0 0 0 0 0 0 0 0 0 0 0 0 0 0 0 0 0
      0 0 0 0 0 0 0 0 0 0 0 0 0 0 106 107 108 0 0 0 0 0 0 0 0 0 0 4145 4146 4147 4148 0 0 0 0 0 0 0 0 0
      0 0 0 0 0 0 0 0 0 0 2625 2626 0 0 109 110 111 0 24 25 0 0 0 0 2622 0 0 4149 4150 4151 4152 0 0 0 0 0 0 0 0 0
      0 0 0 0 0 0 0 0 0 0 0 0 0 0 0 0 0 0 0 0 0 0 0 0 0 0 0 0 0 0 0 0 0 0 0 0 0 0 0 0
      0 0 0 0 0 0 0 0 0 0 0 0 0 0 0 0 0 0 0 0 0 0 0 0 0 0 0 0 0 0 0 0 0 0 0 0 0 0 0 0
      0 0 0 0 0 0 0 0 0 0 0 0 0 0 0 0 0 0 0 0 0 0 0 0 0 0 0 0 0 0 0 0 0 0 0 0 0 0 0 0
      0 0 0 0 0 0 0 0 0 0 0 0 0 0 0 0 0 0 0 0 0 0 0 0 0 0 0 0 0 0 0 0 0 0 0 0 0 0 0 0
      0 0 0 0 0 0 0 0 0 0 0 0 0 0 0 0 0 0 0 0 0 0 0 0 0 0 0 0 0 0 0 0 0 0 0 0 0 0 0 0
      0 0 0 0 0 0 0 0 0 0 0 0 0 0 0 0 0 0 0 0 0 0 0 0 0 0 0 0 0 0 0 0 0 0 0 0 0 0 0 0
      0 0 0 0 0 0 0 0 0 0 0 0 0 0 0 0 0 0 0 0 0 0 0 0 0 0 0 0 0 0 0 0 0 0 0 0 0 0 0 0
      )
    )
    (tilemap
      (solid #f)
      (z-pos -110)
      (width 40)
      (height 30)
      (tiles
      0 0 0 0 0 0 0 0 0 0 0 0 0 0 0 0 0 0 0 0 0 0 0 0 0 0 0 0 0 0 0 0 0 0 0 0 0 0 0 0
      0 0 0 0 0 0 0 0 0 0 0 0 0 0 0 0 0 0 0 0 0 0 0 0 0 0 0 0 0 0 0 0 0 0 0 0 0 0 0 0
      0 0 0 0 0 0 0 0 0 0 0 0 0 0 0 0 0 0 0 0 0 0 0 0 0 0 0 0 0 0 0 0 0 0 0 0 0 0 0 0
      0 0 0 0 0 0 0 0 0 0 0 0 0 0 0 0 0 0 0 0 0 0 0 0 0 0 0 0 0 0 0 0 0 0 0 0 0 0 0 0
      0 0 0 0 0 0 0 0 0 0 0 0 0 0 0 0 0 0 0 0 0 0 0 0 0 0 0 0 0 0 0 0 0 0 0 0 0 0 0 0
      0 0 0 0 0 0 0 0 0 0 0 0 0 0 0 0 0 0 0 0 0 0 0 0 0 0 0 0 0 0 0 0 0 0 0 0 0 0 0 0
      0 0 0 0 0 0 0 0 0 0 0 0 0 0 0 0 0 0 0 0 0 0 0 0 0 0 0 0 0 0 0 0 0 0 0 0 0 0 0 0
      0 0 0 0 0 2052 2053 2053 2054 0 0 0 0 0 2052 2053 2053 2054 0 0 0 0 0 2052 2053 2053 2054 0 0 0 0 0 2052 2053 2053 2054 0 0 0 0
      0 0 0 0 0 2057 2058 2070 2055 2053 2053 2053 2053 2053 2056 2066 2058 2059 0 0 0 0 0 2057 2070 2058 2055 2053 2053 2053 2053 2053 2056 2061 2060 2059 0 0 0 0
      0 0 0 0 0 2062 2051 2061 2061 2066 2058 2058 2058 2065 2060 2066 2050 2064 0 0 0 0 0 2062 2051 2058 2060 2058 2070 2058 2058 2058 2065 2058 2050 2064 0 0 0 0
      0 0 0 0 0 0 2062 2051 2060 2066 2060 2058 2065 2058 2058 2050 2064 0 0 0 0 0 0 0 2062 2051 2058 2058 2058 2065 2058 2058 2058 2050 2064 0 0 0 0 0
      0 0 0 0 0 0 0 2057 2060 2058 2066 2070 2058 2058 2050 2064 0 0 0 0 0 0 0 0 0 2062 2051 2060 2061 2060 2058 2061 2070 2059 0 0 0 0 0 0
      0 0 0 0 0 0 0 2062 2051 2058 2058 2058 2058 2050 2064 0 0 0 0 0 0 0 0 0 0 0 2062 2063 2051 2060 2058 2058 2066 2055 2054 0 0 0 0 0
      0 0 0 0 0 0 0 2052 2056 2060 2061 2058 2070 2059 0 0 0 0 0 0 0 0 0 0 0 0 0 0 2062 2051 2071 2058 2058 2066 2055 2054 0 0 0 0
      0 0 0 0 0 0 2052 2056 2066 2066 2058 2066 2050 2064 0 0 0 0 0 0 0 0 0 0 0 0 0 0 0 2057 2065 2058 2060 2061 2065 2055 2054 0 0 0
      0 0 0 0 0 2052 2056 2058 2058 2050 2051 2061 2059 0 0 0 0 0 0 0 0 0 0 0 0 0 0 0 2052 2056 2065 2060 2058 2065 2058 2058 2059 0 0 0
      0 0 0 0 2052 2056 2061 2058 2050 4244 2056 2060 2059 0 0 0 0 0 0 0 0 0 0 0 0 0 0 0 2062 2051 2071 2058 2058 2058 2066 2060 2059 0 0 0
      0 0 0 2052 2056 2070 2060 2060 2055 2056 2058 2058 2055 2054 0 0 0 0 0 0 0 0 0 0 0 0 0 0 0 2057 2058 2071 2058 2061 2066 2070 2055 2054 0 0
      0 0 2052 2056 2058 2065 2061 2065 2058 2070 2058 2060 2050 2064 0 0 0 0 0 0 0 0 0 0 0 0 0 0 2052 2056 2058 2058 2066 2060 2058 2061 2058 2059 0 0
      0 0 2057 2058 2070 2061 2065 2058 2061 2061 2070 2061 2059 0 0 0 0 0 0 0 0 0 0 0 0 0 0 0 2057 2061 2050 2051 2060 2061 2061 2060 2058 2059 0 0
      0 0 2057 2070 2061 2061 2066 2058 2058 2058 2070 2070 2055 2054 0 0 0 0 0 0 0 0 0 0 0 0 0 2052 2056 2058 2055 2056 2060 2070 2058 2065 2058 2059 0 0
      0 0 2057 2060 2058 2061 2058 2065 2066 2058 2058 2058 2066 2055 2054 0 0 0 0 0 0 0 0 0 0 0 2052 2056 2058 2058 2061 2065 2065 2061 2058 2058 2050 2064 0 0
      0 0 2062 2051 2058 2061 2058 2058 2060 2058 2058 2061 2060 2066 2055 2054 0 0 0 0 0 0 0 0 0 2052 2056 2071 2070 2065 2058 2065 2058 2058 2065 2070 2059 0 0 0
      0 0 0 2062 2051 2061 2060 2065 2058 2058 2058 2058 2058 2066 2070 2059 0 0 0 0 0 0 0 0 0 2057 2058 2061 2071 2058 2058 2058 2066 2061 2050 2063 2064 0 0 0
      0 0 0 0 2062 2063 2051 2058 2058 2058 2065 2065 2058 2050 2063 2064 0 0 0 0 0 0 0 0 0 2062 2063 2051 2058 2066 2058 2061 2066 2050 2064 0 0 0 0 0
      0 0 0 0 0 0 2062 2051 2070 2058 2050 2063 2063 2064 0 0 0 0 0 0 0 0 0 0 0 0 0 2062 2063 2063 2051 2058 2050 2064 0 0 0 0 0 0
      0 0 0 0 0 0 0 2062 2063 2063 2064 0 0 0 0 0 0 0 0 0 0 0 0 0 0 0 0 0 0 0 2062 2063 2064 0 0 0 0 0 0 0
      0 0 0 0 0 0 0 0 0 0 0 0 0 0 0 0 0 0 0 0 0 0 0 0 0 0 0 0 0 0 0 0 0 0 0 0 0 0 0 0
      0 0 0 0 0 0 0 0 0 0 0 0 0 0 0 0 0 0 0 0 0 0 0 0 0 0 0 0 0 0 0 0 0 0 0 0 0 0 0 0
      0 0 0 0 0 0 0 0 0 0 0 0 0 0 0 0 0 0 0 0 0 0 0 0 0 0 0 0 0 0 0 0 0 0 0 0 0 0 0 0
      )
    )
    (tilemap
      (solid #t)
      (z-pos -1)
      (width 40)
      (height 30)
      (tiles
      0 0 0 0 0 0 0 0 0 0 0 0 0 0 0 0 0 0 0 0 0 0 0 0 0 0 0 0 0 0 0 0 0 0 0 0 0 0 0 0
      0 0 0 0 0 0 0 0 0 0 0 0 0 0 0 0 0 0 0 0 0 0 0 0 0 0 0 0 0 0 0 0 0 0 0 0 0 0 0 0
      0 0 0 0 0 0 0 0 0 0 0 0 0 0 0 0 0 0 0 0 0 0 0 0 0 0 0 0 0 0 0 0 0 0 0 0 0 0 0 0
      0 0 0 0 0 0 0 0 0 0 0 0 0 0 0 0 0 0 0 0 0 0 0 0 0 0 0 0 0 0 0 0 0 0 0 0 0 0 0 0
      0 0 0 0 0 0 0 0 0 0 0 0 0 0 0 0 0 0 0 0 0 0 0 0 0 0 0 0 0 0 0 0 0 0 0 0 0 0 0 0
      0 0 0 0 0 0 0 0 0 0 0 0 0 0 0 0 0 0 0 0 0 0 0 0 0 0 0 0 0 0 0 0 0 0 0 0 0 0 0 0
      0 0 0 0 0 0 0 0 0 0 0 0 0 0 0 0 0 0 0 0 0 0 0 0 0 0 0 0 0 0 0 0 0 0 0 0 0 0 0 0
      0 0 0 0 0 0 0 0 0 0 0 0 0 0 0 0 0 0 0 0 0 0 0 0 0 0 0 0 0 0 0 0 0 0 0 0 0 0 0 0
      0 0 0 0 0 0 0 0 0 0 0 0 0 0 0 0 0 0 0 0 0 0 0 0 0 0 0 0 0 0 0 0 0 0 0 0 0 0 0 0
      0 0 0 0 0 0 0 0 0 0 0 0 0 0 0 0 0 0 0 0 0 0 0 0 0 0 0 0 0 0 0 0 0 0 0 0 0 0 0 0
      0 0 0 0 0 0 0 0 0 0 0 0 0 0 0 0 0 0 0 0 0 0 0 0 0 0 0 0 0 0 0 0 0 0 0 0 0 0 0 0
      0 0 0 0 0 0 0 0 0 0 0 0 0 0 0 0 0 0 0 0 0 0 0 0 0 0 0 0 0 0 0 0 0 0 0 0 0 0 0 0
      0 0 0 0 0 0 0 0 0 0 0 0 0 0 0 0 0 0 0 0 0 0 0 0 0 0 0 0 0 0 0 0 0 0 0 0 0 0 0 0
      0 0 0 0 0 0 0 0 0 0 0 0 0 0 0 0 0 0 0 0 0 0 0 0 0 0 0 0 0 0 0 0 0 0 0 0 0 0 0 0
      0 0 0 0 0 0 0 0 0 0 0 0 0 0 0 0 0 0 0 0 0 0 0 0 0 0 0 0 0 0 0 0 0 0 0 0 0 0 0 0
      0 0 0 0 0 0 0 0 0 0 0 0 0 0 0 0 0 0 0 0 0 0 0 0 0 0 0 0 0 0 0 0 0 0 0 0 0 0 0 0
      0 0 0 0 0 0 0 0 0 0 0 0 0 0 0 0 0 0 0 0 0 0 0 0 0 0 0 0 0 0 0 0 0 0 0 0 0 0 0 0
      0 0 0 0 0 0 0 0 0 0 0 0 0 0 0 0 0 0 0 0 0 0 0 0 0 0 0 0 0 0 0 0 0 0 0 0 0 0 0 0
      0 0 0 0 0 0 0 0 0 0 0 0 0 0 0 0 0 0 0 0 0 0 0 0 0 0 0 0 0 0 0 0 0 0 0 0 0 0 0 0
      0 0 0 0 0 0 0 0 0 0 0 0 0 0 0 0 0 0 0 0 0 0 0 0 0 0 0 0 0 0 0 0 0 0 0 0 0 0 0 0
      0 0 0 0 0 0 0 0 0 0 0 0 0 0 0 0 0 0 0 0 0 0 0 0 0 0 0 0 0 0 0 0 0 0 0 0 0 0 0 0
      0 0 0 0 0 0 0 0 0 0 0 0 0 0 0 0 0 0 0 0 0 0 0 0 0 0 0 0 0 0 0 0 0 0 0 0 0 0 0 0
      0 0 0 0 0 0 0 0 0 0 0 0 0 0 0 0 0 0 0 0 0 0 0 0 0 0 0 0 0 0 0 0 0 0 0 0 0 0 0 0
      0 0 0 0 0 0 0 0 0 0 0 0 0 0 0 0 0 0 0 0 0 0 0 0 0 0 0 0 0 0 0 0 0 0 0 0 0 0 0 0
      0 0 0 0 0 0 0 0 0 0 0 0 0 0 0 0 0 0 0 0 0 0 0 0 0 0 0 0 0 0 0 0 0 0 0 0 0 0 0 0
      0 0 0 0 0 0 0 0 0 0 0 0 0 0 0 0 0 0 0 0 0 0 0 0 0 0 0 0 0 0 0 0 0 0 0 0 0 0 0 0
      0 0 0 0 0 0 0 0 0 0 0 0 0 0 0 0 0 0 0 0 0 0 0 0 0 0 0 0 0 0 0 0 0 0 0 0 0 0 0 0
      0 0 0 0 0 0 0 0 0 0 0 0 0 0 0 0 0 0 0 0 0 0 0 0 0 0 0 0 0 0 0 0 0 0 0 0 0 0 0 0
      0 0 0 0 0 0 0 0 0 0 0 0 0 0 0 0 0 0 0 0 0 0 0 0 0 0 0 0 0 0 0 0 0 0 0 0 0 0 0 0
      0 0 0 0 0 0 0 0 0 0 0 0 0 0 0 0 0 0 0 0 0 0 0 0 0 0 0 0 0 0 0 0 0 0 0 0 0 0 0 0
      )
    )
    (tilemap
      (solid #f)
      (z-pos 100)
      (width 40)
      (height 30)
      (tiles
      0 0 0 0 0 0 0 0 0 0 0 0 0 0 0 0 0 0 0 0 0 0 0 0 0 0 0 0 0 0 0 0 0 0 0 0 0 0 0 0
      0 0 0 0 0 0 0 0 0 0 0 0 0 0 0 0 0 0 0 0 0 0 0 0 0 0 0 0 0 0 0 0 0 0 0 0 0 0 0 0
      0 0 0 0 0 0 0 0 0 0 0 0 0 0 0 0 0 0 0 0 0 0 0 0 0 0 0 0 0 0 0 0 0 0 0 0 0 0 0 0
      0 0 0 0 0 0 0 0 0 0 0 0 0 0 0 0 0 0 0 0 0 0 0 0 0 0 0 0 0 0 0 0 0 0 0 0 0 0 0 0
      0 0 0 0 0 0 0 0 0 0 0 0 0 0 0 0 0 0 0 0 0 0 0 0 0 0 0 0 0 0 0 0 0 0 0 0 0 0 0 0
      0 0 0 0 0 0 0 0 0 0 0 0 0 0 0 0 0 0 0 0 0 0 0 0 0 0 0 0 0 0 0 0 0 0 0 0 0 0 0 0
      0 0 0 0 0 0 0 0 0 0 0 0 0 0 0 0 0 0 0 0 0 0 0 0 0 0 0 0 0 0 0 0 0 0 0 0 0 0 0 0
      0 0 0 0 0 0 0 0 0 0 0 0 0 0 0 0 0 0 0 0 0 0 0 0 0 0 0 0 0 0 0 0 0 0 0 0 0 0 0 0
      0 0 0 0 0 0 0 0 0 0 0 0 0 0 0 0 0 0 0 0 0 0 0 0 0 0 0 0 0 0 0 0 0 0 0 0 0 0 0 0
      0 0 0 0 0 0 0 0 0 0 0 0 0 0 0 0 0 0 0 0 0 0 0 0 0 0 0 0 0 0 0 0 0 0 0 0 0 0 0 0
      0 0 0 0 0 0 0 0 0 0 0 0 0 0 0 0 0 0 0 0 0 0 0 0 0 0 0 0 0 0 0 0 0 0 0 0 0 0 0 0
      0 0 0 0 0 0 0 0 0 0 0 0 0 0 0 0 0 0 0 0 0 0 0 0 0 0 0 0 0 0 0 0 0 0 0 0 0 0 0 0
      0 0 0 0 0 0 0 0 0 0 0 0 0 0 0 0 0 0 0 0 0 0 0 0 0 0 0 0 0 0 0 0 0 0 0 0 0 0 0 0
      0 0 0 0 0 0 0 0 0 0 0 0 0 0 0 0 0 0 0 0 0 0 0 0 0 0 0 0 0 0 0 0 0 0 0 0 0 0 0 0
      0 0 0 0 0 0 0 0 0 0 0 0 0 0 0 0 0 0 0 0 0 0 0 0 0 0 0 0 0 0 0 0 0 0 0 0 0 0 0 0
      0 0 0 0 0 0 0 0 0 0 0 0 0 0 0 0 0 0 0 0 0 0 0 0 0 0 0 0 0 0 0 0 0 0 0 0 0 0 0 0
      0 0 0 0 0 0 0 0 0 0 0 0 0 0 0 0 0 0 0 0 0 0 0 0 0 0 0 0 0 0 0 0 0 0 0 0 0 0 0 0
      0 0 0 0 0 0 0 0 0 0 0 0 0 0 0 0 0 0 0 0 0 0 0 0 0 0 0 0 0 0 0 0 0 0 0 0 0 0 0 0
      0 0 0 0 0 0 0 0 0 0 0 0 0 0 0 0 0 0 0 0 0 0 0 0 0 0 0 0 0 0 0 0 0 0 0 0 0 0 0 0
      0 0 0 0 0 0 0 0 0 0 0 0 0 0 0 0 0 0 0 0 0 0 0 0 0 0 0 0 0 0 0 0 0 0 0 0 0 0 0 0
      0 0 0 0 0 0 0 0 0 0 0 0 0 0 0 0 0 0 0 0 0 0 0 0 0 0 0 0 0 0 0 0 0 0 0 0 0 0 0 0
      0 0 0 0 0 0 0 0 0 0 0 0 0 0 0 0 0 0 0 0 0 0 0 0 0 0 0 0 0 0 0 0 0 0 0 0 0 0 0 0
      0 0 0 0 0 0 0 0 0 0 0 0 0 0 0 0 0 0 0 0 0 0 0 0 0 0 0 0 0 0 0 0 0 0 0 0 0 0 0 0
      0 0 0 0 0 0 0 0 0 0 0 0 0 0 0 0 0 0 0 0 0 0 0 0 0 0 0 0 0 0 0 0 0 0 0 0 0 0 0 0
      0 0 0 0 0 0 0 0 0 0 0 0 0 0 0 0 0 0 0 0 0 0 0 0 0 0 0 0 0 0 0 0 0 0 0 0 0 0 0 0
      0 0 0 0 0 0 0 0 0 0 0 0 0 0 0 0 0 0 0 0 0 0 0 0 0 0 0 0 0 0 0 0 0 0 0 0 0 0 0 0
      0 0 0 0 0 0 0 0 0 0 0 0 0 0 0 0 0 0 0 0 0 0 0 0 0 0 0 0 0 0 0 0 0 0 0 0 0 0 0 0
      0 0 0 0 0 0 0 0 0 0 0 0 0 0 0 0 0 0 0 0 0 0 0 0 0 0 0 0 0 0 0 0 0 0 0 0 0 0 0 0
      2123 0 0 0 0 0 0 0 0 0 0 0 2121 2122 2122 2123 0 0 0 0 0 0 0 0 2121 2122 2123 0 0 0 0 0 0 0 0 0 0 0 0 2121
      2129 2122 2123 0 0 0 0 0 0 0 2121 2122 2130 4780 4780 2129 2122 2122 2123 0 0 0 0 2121 2130 4780 2129 2122 2123 0 0 0 0 0 0 0 0 2121 2122 2130
      )
    )
    (yeti
      (dead-script "sector.Tux.trigger_sequence(\"fireworks\");")
      (x 96)
      (y 384)
      (fixed-pos #t)
    )
    (yeti_stalactite
      (x 256)
      (y 288)
    )
    (yeti_stalactite
      (x 288)
      (y 296)
    )
    (yeti_stalactite
      (x 320)
      (y 312)
    )
    (yeti_stalactite
      (x 352)
      (y 320)
    )
    (yeti_stalactite
      (x 384)
      (y 320)
    )
    (yeti_stalactite
      (x 416)
      (y 320)
    )
    (yeti_stalactite
      (x 448)
      (y 320)
    )
    (yeti_stalactite
      (x 480)
      (y 320)
    )
    (yeti_stalactite
      (x 512)
      (y 312)
    )
    (yeti_stalactite
      (x 544)
      (y 296)
    )
    (yeti_stalactite
      (x 576)
      (y 288)
    )
    (yeti_stalactite
      (x 608)
      (y 288)
    )
    (yeti_stalactite
      (x 640)
      (y 288)
    )
    (yeti_stalactite
      (x 672)
      (y 288)
    )
    (yeti_stalactite
      (x 704)
      (y 288)
    )
    (yeti_stalactite
      (x 736)
      (y 296)
    )
    (yeti_stalactite
      (x 768)
      (y 312)
    )
    (yeti_stalactite
      (x 800)
      (y 320)
    )
    (yeti_stalactite
      (x 832)
      (y 320)
    )
    (yeti_stalactite
      (x 864)
      (y 320)
    )
    (yeti_stalactite
      (x 896)
      (y 320)
    )
    (yeti_stalactite
      (x 928)
      (y 312)
    )
    (yeti_stalactite
      (x 960)
      (y 296)
    )
    (yeti_stalactite
      (x 992)
      (y 288)
    )
  )
)
